#####################
#........###........#
#...................#
#...................#
#.....#..###..#.....#
#.1...#..###..#...2.#
#.....#..###..#.....#
#.....#.......#.....#
#.....#.......#.....#
#.....#########.....#
#...................#
#####################