#####################
#....#..#....#......#
#.........#.......1.#
#....#####.#.....#..#
#...................#
#..#...#.....#..###.#
#.##....#...#.#...#.#
#..#................#
#.........#....#....#
#.2.......#..#......#
#...##..............#
#####################