#####################
#...................#
#.................1.#
#................#..#
#................#..#
#.###.#.#...#.#.###.#
#.###.#.#...#.#.###.#
#..#................#
#..#................#
#.2.................#
#...................#
#####################